FFFOFOFFF
FOFFFFFOF
FFFOSOFFF
FOFFFFFOF
FOOFOFOFF
FFFFFFFFF
