FFFOFOFFF
FOFFFFFOF
FFFOSOFFF
FOFFFFFOF
FOOFOFOOF
FFFFFFFFF
