FFFFFFFFF
FOFFFFFOF
FOFOSOFOF
FOFFFFFOF
FFOOFOOFF
FFFFOFFFF
