FFFOFOFFF
FOFFFFFOF
FOFOSOFOF
FOFFFFFOF
FFFOFOFFF
FFFFOFFFF
