FFFFFFFFF
FOFFFFFOF
FOFOSOFOF
FOFFFFFOF
FFOFFFOOF
FFFOFOFFF