FFOOFOOFF
FFFFFOFFF
FFFOSOOFO
OFOFFFFFF
FFFFFOFFF
FFOFFFFFF
