FFFFFFFOF
OOFFFFFFF
FFOOSOFFF
FFFFFFFOF
FFFOOOFOF
FFFOFFFOF
