FFFFFFFFF
FOFFFFFOF
FOFOSOFOF
FOFFFFFOF
FOOFOFOOF
FFFFFFFFF
