FFFFFFFFF
FOFFFFFOF
FOFOSOFOF
FOFFFFFOF
FOFOOOFOF
FFFFFFFFF
